R 800 600


EA ./textures/greystone.xpm
NO ./textures/redbrick.xpm
SO ./textures/wood.xpm
WE ./textures/mossy.xpm
S ./textures/sprite.xpm
F 45,50,55
C 60,65,75




        1111111111111111111111111
        100000000011200000000001
        1011000001112000000000001
        1001202020202000000W00001
111111111011000001112000000000001
100000000011000001110111111111111
11110111111111011100000010001
11110111111111011101010010001
11000000110101011100000012001
10000000000000001100000010001
10000000000000001101010010001
110000011101010111101111020111
11110111 1110101 101111010001
11111111 1111111 111111111111