R     800 600
   NO ../textures/redbrick.xpm
    SO ../textures/wood.xpm
   WE ../textures/mossy.xpm
EA ../textures/greystone.xpm
S ../textures/sprite.xpm
F  45,45,45
C    46,71,213
        1111111111111111111111111
        1000000000110000000000001
        101100000111000000W000001
        1001000000000100000000111
1111111101100000111001000000001
100000000011000001110111110111111
111101111111110111000000100011111
11110111111111011101010010001
11000000110101011100000010001
10002010000111001100000010001
100001000001 1001001010010001
1100000111011101 11101111000111
11110111 1110101 101111010001
11111111 1111111 111111111111
