111111111
100000001
120000001
102000001
100200001
100100001
100002001
1000N0001
111111111