111111111
100000001
100000001
120000001
100000001
100000001
100020001
1000N0001
111111111